> 元始天尊 - 靈寶天尊 - 道德天尊
玉皇上帝 - 后土娘娘 - 紫微 - 勾陳
南極長生大帝 - 太乙救苦天尊
> 先天尊神
西王母 - 东王公
斗姥元君 - 三官大帝 - 五方五老
玄天上帝 - 雷聲普化天尊
> 天地山川百神
九皇大帝 - 太陽星君 - 太陰星君
魁斗星君 - 嫦娥娘娘
東嶽大帝 - 水仙尊王 - 四海龍王
金光聖母 - 雷公
> 冥府
酆都大帝 - 十殿閻君 - 五方鬼帝
黑白無常 - 陰陽司 - 判官 - 日夜遊神
> 聖賢仙真
盘古 - 女娲 - 伏羲 - 神农 - 黄帝
八仙 - 純陽祖師
九天玄女 - 骊山老母
百花仙子- 麻姑 - 三茅真君 - 黃大仙
> 護法神
托塔李天王 - 中壇元帥 - 二郎真君
驅魔真君鍾馗 - 關聖帝君
溫元帥 - 田都元帥 - 四大元帥
馬天君 - 王靈官 - 五營神將
法主真君 - 輔天真君 - 弼天真君
> 民間俗神
天上聖母 - 泰山娘娘 - 灶君 - 福祿壽 - 財神 - 门神 - 城隍 - 境主 - 福德正神 - 月老 - 文昌帝君 - 天醫真人 - 包公 -保生大帝 - 開漳聖王 - 廣澤尊王 - 靈安尊王 - 三山國王 - 古公三王 - 九龍三公 -西秦王爺 - 洪聖大王 - 虎爺 - 七星娘娘 - 金花娘娘 - 臨水夫人 - 註生娘娘 - 武夷真君 - 巧聖先師 - 岳武穆王 - 姜太公 - 張仙 - 清水祖師 - 董公祖師 - 五府千歲 - 五年千歲 - 五福王爺
> 正一道是宋、元朝形成的道教宗派，來自於漢朝的五斗米道。全稱作「正一盟威之道」，奉张天师为首领，道术以画符念咒为主，道士一般娶妻生子，不必出家。按金允中《上清靈寶大法》的記載，正一宗壇在信州之龍虎山，受正一之籙，行天心正法[1]。
> 元以后为上清派，灵宝派和天师道等的总称。宋嘉熙三年（1239），宋理宗命第三十五代张天师张可大提举三山（龙虎山、茅山、阁皂山）符箓兼御前诸宫观教门公事，主领龙翔宫，赐号“观妙先生”。元成宗大德八年（1304）授三十八代张天师张与材“正一教主，主领三山符箓”，为正一道形成的标志。明初，官方承认的道教只有全真、正一等兩派，天师派以外的符箓诸派，包括禪和派、神霄派、清微派、天心派、东华派、净明道、太一道等，皆被视为正一派的分支。
2 参考文献[编辑]
2 外部連結[编辑]
